1
211112
110011
150001
104301
100001
104301
100001
100001
111111
2
22111112
11100012
14530012
11103412
14113012
10104011
13063341
10004001
11111111
3
1111111
1005001
1031111
1141222
2111222